22222222222222222222222222222222222222222222222222222222222222222
2001000010000000000000000000D000000000000000000000000000000000002
22220000000000000000000B00000000000000000000000000000000000000002
200000000000000B0000000000000000000000000000000000000000000000002
2101000000000000000B000002222222222222222200000000000000000000002
20000000000000000000000000000000000000000200000000000000000000002
2222000000000000000011111111000B000000000200000000000000000000002
20000000000000000000111111110000000000002200000000000000000000002
21010000000000000000000000000000000000020000000000000000000000002
2000000000000000000000000000B000000022200000000000000000000000002
20010000000000000000000B00000002222220000000000000000000000000002
22220000000000000000000001111000000000000000000000000000000000002
20000000000000B000000111111111100000000000000000B0000000000000002
21010000000000B00000000000000000000000000000000000000000000000002
20000000000000B000000000000000000000000000000D0000000000000000002
20010000100000000000000000000000000000000000000000000000000000002
22220000000000000000000000000000000000000000000000000000000000002
20000000000000000000000000000000000000000000000000000000000000002
21010000000000000000000002222222222222222200000000000000000000002
20000000000000000000000000000000000000000200000000000000000000002
222200000000000000001111111100000000B0000020000000000000000000002
200000000000000000001111111100000000B0000220000000000000000000002
21010000000000000000000000000000000B00002000000000000000000000002
20000000000000B000000B0000000000000000222000000000000000000000002
20010000000000000000000000000002222220000000000000000000000000002
22220000000000000000000001111000000000000000000000000000000000002
200000000000000000001111111111000000000000000000000B0000000000002
2101000000000000000000000000000000000000000000000000B000000D00002
20000000000000000000000000000000000000000000000000000BBB000000002
22222222222222222222222222222222222222222222222222222222222222222