22222222222222222222222222222222222222222222222222222222222222222
2001000010000000000000000000D000000000000000000000000000000000002
2222222222222222BBBB222222200020000000000000000000000000000000002
200000000000000B000B000000200000000000000000000000000000000000002
2101000000222222000BBBBBBB2BBBBBB00000222222222222222220000000002
20000000002000000000000000200000000000000200000000000000000000002
2222000000200000000011111111000B000000000200000000000000000000002
20000000222222222222111111110000000000002200000000000000000000002
21010000000000000000000000000000000000020000000000000000000000002
2000000000000000000000000000B00000002220000000D000000000000000002
20011111111111111111000B000002222222200000000D000000000В000000002
22220000000000001011100001111000000000000000000000000000000000002
20000000000000B000000111111111100000000000000000B0000000000000002
21010000000000B000000000000000200000000000000000000000000В0000002
20000000000000B000000100000010221100000100011000DDDDDDDDDDDDDDBB2
20010000100000000000001000101001001000010010100000000000010000002
22220000000000000000000101000111111110010100100000000000000000002
20000000000000000000000010000100000010010000100000000000000000002
21010000000000000000000012222222222222222200000000000000000000002
20000000000000000000000000000000000000000200000000000000000000002
222200000000000000001111111100000000B0000020000000000000000000002
200000000000000000001111111100000000B0000220000000000000000000002
21010000000000000000000000000000000B00002000000000000000000000002
20000000000000B00000000000000000000000222000000000000000000000002
20010000000000000000000000000002222220000000000000000000000000002
22220000000000000000000001111000000000000000000000000000000000002
200000000000000000001111111111000000000000000000000B0000000000002
2101000000000000000000000000000000000000000000000000B000000D00002
20000000000000000000000000000000000000000000000000000BBB000000002
22222222222222222222222222222222222222222222222222222222222222222