22222222222222222222222222222222222222222222222222222222222222222
20010000100000000000000000000000000000000000000000000000000000002
222200000000000000002000B2000000000000000000000000000000000000002
2000000000202020202202B220000000000000000000000000000000000000002
21010000020000000000B00002202222200000022222220220202022000000002
20000000000000000000000000000000000000000200000000000000020000002
2222000000000000000011111111000B000000000200000000000000020000002
20000000000000000000111111110000000000002200000000000000022000002
210100000000000000000000000000000000000200000000000D0000020000002
2000000000000000000000000000B000000022200000000000000000020000002
20010000000000000000000B00000002222220000000000000000000022000002
22220000000000000000000001111000000000000000222222220000002000002
20000000000000B000000111111111100000000000002000B0000000002000002
21010000000000B00000000000000000000000000000200000000000000220002
20000000000000B0B000000000000000000000000000200000000000000200002
200100001000000000000000000000000000000B0000200000000000000000002
22220000000BBBBB0000000000000000000000B00000200000000000000000002
20000000000000000000000000000000000000000000200000000000000000002
210100000000000B0000000002222222222222222200200000000000000000002
20000000000D00000000000000000000000000000200200000000000000000002
222200000000000000001111111100000000B0000022000000000000000000002
20000000000000000001111111100000000B00000000000000000000000000002
21010000000000000000000000000000000B00002000000000000000000000002
20000000000000B000000B0000000000000000222000000000000000000000002
20010000000000000000000000000002222220000000000000000000000000002
22220000000000000000000001111000000000000000000000000000000000002
200000000000000000001111111111000000000000B00000000B0000000000002
2101000000000000000000000000000000000000000000000000B000000000002
2000000000000000000000000BBBB000000000000000000000000BBB000000002
22222222222222222222222222222222222222222222222222222222222222222